BURGOS -> CANTABRIA, PALENCIA, LA RIOJA, SORIA, SEGOVIA, VALLADOLID, ALAVA, VIZCAYA
CUENCA -> TOLEDO, CIUDAD REAL, ALBACETE, VALENCIA, TERUEL, GUADALAJARA, MADRID
ALBACETE -> CIUDAD REAL, CUENCA, MURCIA, VALENCIA, ALICANTE, JAEN, GRANADA
LEON -> LUGO, ORENSE, ASTURIAS, ZAMORA, VALLADOLID, PALENCIA, CANTABRIA
ZARAGOZA -> NAVARRA, SORIA, HUESCA, GUADALAJARA, TERUEL, LERIDA, TARRAGONA
VALLADOLID -> LEON, ZAMORA, SALAMANCA, AVILA, SEGOVIA, PALENCIA, BURGOS
TERUEL -> ZARAGOZA, GUADALAJARA, CUENCA, VALENCIA, CASTELLON, TARRAGONA
BADAJOZ -> CACERES, CIUDAD REAL, TOLEDO, CORDOBA, HUELVA, SEVILLA
TOLEDO -> MADRID, AVILA, CACERES, BADAJOZ, CIUDAD REAL, CUENCA
GUADALAJARA -> MADRID, SEGOVIA, SORIA, ZARAGOZA, TERUEL, CUENCA
CIUDAD REAL -> TOLEDO, BADAJOZ, CUENCA, ALBACETE, CORDOBA, JAEN
AVILA -> VALLADOLID, SEGOVIA, SALAMANCA, CACERES, TOLEDO, MADRID
SEGOVIA -> VALLADOLID, AVILA, BURGOS, SORIA, MADRID, GUADALAJARA
LUGO -> LA CORUNA, PONTEVEDRA, ORENSE, ASTURIAS, LEON
CANTABRIA -> ASTURIAS, VIZCAYA, ALAVA, LEON, PALENCIA, BURGOS
PONTEVEDRA -> LUGO, ORENSE, LA CORUNA
ORENSE -> PONTEVEDRA, LUGO, ZAMORA, LEON
ASTURIAS -> LUGO, LEON, CANTABRIA
ZAMORA -> ORENSE, LEON, SALAMANCA, VALLADOLID
SALAMANCA -> ZAMORA, CACERES, AVILA, VALLADOLID
PALENCIA -> LEON, CANTABRIA, BURGOS, VALLADOLID
SORIA -> BURGOS, SEGOVIA, GUADALAJARA, LA RIOJA, ZARAGOZA
VIZCAYA -> CANTABRIA, GUIPUZCOA, ALAVA, BURGOS
GUIPUZCOA -> VIZCAYA, ALAVA, NAVARRA
ALAVA -> VIZCAYA, GUIPUZCOA, NAVARRA, LA RIOJA, BURGOS
LA RIOJA -> BURGOS, SORIA, NAVARRA, ALAVA
NAVARRA -> GUIPUZCOA, ALAVA, LA RIOJA, ZARAGOZA, HUESCA
HUESCA -> NAVARRA, ZARAGOZA, LERIDA
LERIDA -> HUESCA, ZARAGOZA, TARRAGONA, BARCELONA, GERONA
TARRAGONA -> LERIDA, BARCELONA, ZARAGOZA, TERUEL, CASTELLON
MADRID -> AVILA, SEGOVIA, GUADALAJARA, TOLEDO, CUENCA
CACERES -> SALAMANCA, AVILA, TOLEDO, BADAJOZ
CASTELLON -> TERUEL, TARRAGONA, VALENCIA
VALENCIA -> CASTELLON, TERUEL, CUENCA, ALBACETE, ALICANTE
ALICANTE -> VALENCIA, ALBACETE, MURCIA
MURCIA -> ALICANTE, ALBACETE, GRANADA, ALMERIA
HUELVA -> BADAJOZ, SEVILLA, CADIZ
SEVILLA -> BADAJOZ, HUELVA, CORDOBA, CADIZ, MALAGA
CORDOBA -> BADAJOZ, CIUDAD REAL, JAEN, GRANADA, MALAGA, SEVILLA
MALAGA -> CADIZ, SEVILLA, CORDOBA, GRANADA
GRANADA -> ALMERIA, JAEN, CORDOBA, MALAGA, MURCIA, ALBACETE
JAEN -> CIUDAD REAL, ALBACETE, CORDOBA, GRANADA
ALMERIA -> MURCIA, GRANADA
LA CORUNA -> LUGO, PONTEVEDRA
BARCELONA -> GERONA, LERIDA, TARRAGONA
GERONA -> LERIDA, BARCELONA
CADIZ -> HUELVA, SEVILLA, MALAGA